Internet= Conjumnto de redes de computador

HTTP= Protocolo de navegação web

TCP/IP= Conjunto de protocolos de comunicação(TCP faz a entrega dos dados em pacotes/IP obtemm o endereço que identifica cada maquina na rede)

URL= Endereço do site

Dominio= Nome unico de um site

Sub Dominio= Complemento que fica do lado esquerdo de um dominio, antes do ponto(Não obrigatorio)

TLD= (top-level domain)Commplemento que fica do lado direito do dominio depois do ponto(Identifica o proposito do site)

gTLD= TLD genericos(.com(comerciais), .org(organizações), .net(redes) etc) para todos os tipos de usuarios

ccTLD= TLD com codigo ISO de paises(.br(Brasil),  .es(Espanha), .ru(Russia) etc)

sTLD= TLD operados por organizações privadas(.gov(governamentais), .edu(educacionais), .mil(exercito dos EUA))

DNS= Servidores especiais que convertem o dominio em IP

HTML= Linguagem de Conteudo

CSS= Linguagem de Design

JavaScript= Linguagem de Interações

JPEG= Melhor compactação

PNG= Compactação e permmite transparencia

GIF= Permite transparencia e animação mas com qualidade de imagem pessima

PageRank= Ferramenta que avalia a importancia de um site em relação a outro e organiza sua posição no mecanismo de busca do Google

Link Juice= Parcela de otimização de rankeamento que cada link transmite para a página de destino.

Decimal= 0, 1, 2, 3, 4, 5, 6, 7, 8, 9
Hexadecimal= 0, 1, 2, 3, 4, 5, 6, 7, 8, 9, A, B, C, D, E, F

Medidas absolutas= cm(centimetro), mm(milimetro), in(polegada), px(pixel), pt(ponto), pc(paica)
Medidas Relativas= em(Relativo ao tamanho atual da fonte), ex(Relativo a altura x), rem(Relativo a fonte do body), vwvw(Relativo ao largura da tela), vh(Relativo a altura da tela), %

Fontes handwritten= Fontes que imitam letra cursiva

Formatos de arquivos de fonte(
-opentype= otf
-truetype= ttf
-embedded-opentype
-truetype-aut(Apple Advanced Typography)
-sgv)

id sobrepoe class
Só pode ter um id igual no html

height= altura
width= largura

Anatomia de caixa=Conteudo-> preenchimento-> traçado-> borda-> margem 
box-level= Ocupa toda a largura da tela e quebra a linha(div, h1-h6, p, main, header, nav, article, aside, footer, form, video)
inline-level= Ocupa o espaço nesseçario para o elemento e não quebra a linha(span, a, code, small, strong, em, sup-sub, label, button, input, select)

user agent= Navegador

Hierarquia de tabela pequenas(
  table= tabela,
  table row= linha de tabela,
  table header= cabeçalho de tabela,
  table date= dados de tabela)

Hierarquia de tabelas grandes(
  table= tabela,
  caption= legenda/titulo da tabela,
  thead= cabeça da tabela[tr, td, th] (Não é obrigatorio)
  tbody= corpo da tabela[tr, td, th],
  tfoot= pé da tabela[tr, td, th] (Não é obrigatorio)) 

O fechamento de tr e td não são obrigatorios

Tamanho padrao do iframe 300x150